+---+---+---+---+---+---+---+
|   |                       |
+   +---+---+---+---+---+   +
|                           |
+   +---+---+---+---+---+---+
|                           |
+---+---+---+---+---+---+   +
|                           |
+   +---+---+---+---+---+---+
|                           |
+---+---+---+---+---+---+---+