┏━━━┳━━━┳━━━┳━━━┳━━━┳━━━┳━━━┓
┃   ┃                       ┃
┣   ╋━━━╋━━━╋━━━╋━━━╋━━━╋   ┫
┃                           ┃
┣   ╋━━━╋━━━╋━━━╋━━━╋━━━╋━━━┫
┃                           ┃
┣━━━╋━━━╋━━━╋━━━╋━━━╋━━━╋   ┫
┃                           ┃
┣   ╋━━━╋━━━╋━━━╋━━━╋━━━╋━━━┫
┃                           ┃
┗━━━┻━━━┻━━━┻━━━┻━━━┻━━━┻━━━┛