┏━━━┳━━━┳━━━┳━━━┳━━━┳━━━┳━━━┓
┃                           ┃
┣   ╋━━━╋━━━╋━━━╋━━━╋━━━╋   ┫
┃                       ┃   ┃
┣━━━╋━━━╋━━━╋━━━╋━━━╋━━━╋   ┫
┃                           ┃
┣━━━╋━━━╋━━━╋━━━╋━━━╋━━━╋   ┫
┃                           ┃
┣   ╋━━━╋━━━╋━━━╋━━━╋━━━╋━━━┫
┃                           ┃
┗━━━┻━━━┻━━━┻━━━┻━━━┻━━━┻━━━┛