+---+---+---+---+---+---+---+
|                           |
+   +---+---+---+---+---+   +
|                       |   |
+---+---+---+---+---+---+   +
|                           |
+---+---+---+---+---+---+   +
|                           |
+   +---+---+---+---+---+---+
|                           |
+---+---+---+---+---+---+---+